トキノソラ	ときのそら	人名
アズキ	AZKi	人名
ロボコサン	ロボ子さん	人名
サクラミコ	さくらみこ	人名
シラカミフブキ	白上フブキ	人名
ナツイロマツリ	夏色まつり	人名
ヨゾラメル	夜空メル	人名
アカイハアト	赤井はあと	人名
アキローゼンタール	アキ・ローゼンタール	人名
ミナトアクア	湊あくあ	人名
ユヅキチョコ	癒月ちょこ	人名
ナキリアヤメ	百鬼あやめ	人名
ムラサキシオン	紫咲シオン	人名
オオゾラスバル	大空スバル	人名
オオカミミオ	大神ミオ	人名
ネコマタオカユ	猫又おかゆ	人名
イヌガミコロネ	戌神ころね	人名
シラヌイフレア	不知火フレア	人名
シロガネノエル	白銀ノエル	人名
ホウショウマリン	宝鐘マリン	人名
ウサダペコラ	兎田ぺこら	人名
ウルハルシア	潤羽るしあ	人名
ホシマチスイセイ	星街すいせい	人名
アマネカナタ	天音かなた	人名
キリュウココ	桐生ココ	人名
ツノマキワタメ	角巻わため	人名
トコヤミトワ	常闇トワ	人名
ヒメモリルーナ	姫森ルーナ	人名
ユキハナラミィ	雪花ラミィ	人名
ユキハナラミィ	桃鈴ねね	人名
マノアロエ	魔乃アロエ	人名