ときのそら	ときのそら	人名
＠ときのそら	🐻💿	人名
あずき	AZKi	人名
ろぼこさん	ロボ子さん	人名
さくらみこ	さくらみこ	人名
しらかみふぶき	白上フブキ	人名
なついろまつり	夏色まつり	人名
よぞらめる	夜空メル	人名
あかいはあと	赤井はあと	人名
あきろーぜんたーる	アキ・ローゼンタール	人名
みなとあくあ	湊あくあ	人名
ゆづきちょこ	癒月ちょこ	人名
なきりあやめ	百鬼あやめ	人名
むらさきしおん	紫咲シオン	人名
おおぞらすばる	大空スバル	人名
おおかみみお	大神ミオ	人名
ねこまたおかゆ	猫又おかゆ	人名
いぬがみころね	戌神ころね	人名
しらぬいふれあ	不知火フレア	人名
しろがねのえる	白銀ノエル	人名
ほうしょうまりん	宝鐘マリン	人名
うさだぺこら	兎田ぺこら	人名
うるはるしあ	潤羽るしあ	人名
ほしまちすいせい	星街すいせい	人名
あまねかなた	天音かなた	人名
きりゅうここ	桐生ココ	人名
つのまきわため	角巻わため	人名
とこやみとわ	常闇トワ	人名
ひめもりるーな	姫森ルーナ	人名
ゆきはならみぃ	雪花ラミィ	人名
ゆきはならみぃ	桃鈴ねね	人名
まのあろえ	魔乃アロエ	人名